                                                                                                                                                                                                                                                                                                    FFF    
                                                                                                                            G     GGGGG                                                                                                                                                             FFF    
                                                                                     @                                GG  GGG  GG                                                                                                                                                                   FFF    
                                                         GG  GG  GG  GG  GSG  GSG  GGGGG  GGGG  GG  GG  GG  GG  GG GG                                                                                                                                                                               FFF    
                          GGG  GGG  GGG  GG   G  G  G GGG                                                                                                                                                                                                                                           FFF    
                       G                                                                                                                                                                                                                                                                            FFF    
                    G             G     G      G                                                                                                        GG                                                                                                                                          FFF    
                 G        GG      S     S      S          G GG   GG                                                                              G      SS                                 G  GGGGG                    GGGSSG   GGSGG                                                     G         FFF    
   P          GGSSSGGGSGSGGGGG                         G     SSSSS    G               S     S     S     S     S     S     S     S              GGGSGGG       GGGSGGG   S      GG  GGG    GGG                   GGGSSGGG                GGGSSGGSSSGGGGG  SGGGSG                        GGGGGSSS      FFF    
GGGGGGGGGGGGGGGGGGGGGGGGGGGGGGGGGGGGGGGGGGGGGGGGGGGGGGGGGGGGGGGGGGGGGGGGGGGGGGGGGGGGGGGGGGGGGGGGGGGGGGGGGGGGGGGGGGGGGGGGGGGGGGGGGGGGGGGGGGGGGGGGGGGGGGGGGGGGGGGGGGGGGGGGGGGGGGGSSGGGSSSSGGGGGGGGGGGGGGGGGGGGGGGGGGGGGGGGGGGGGGGGGGGGGGGGGGGGGGGGGGGGGGGGGGGGGGGGGGGGGGGGGGGGGGGGGGGGGGGGGGGGGGGGGGGGGGGGGG 
