                                                                                                                                           F                                                                                                                                                               
                                                                                                                                           F                                                                                                                                                               
                                 GGGGGS GGSGGSGGSGG G   G   G   G                                                                          F                                                                                                                                                               
                          GGGGGG                                          GGGG          GGGG                                          @    F                                                                                                                                                               
                                                                   GGGGG         GGGG          GGGGG                                  G    F                                                                                                                                                               
                 GGGGGGG                                                                                                           G       F                                                                                                                                                               
                                                                                                     GGGGGSGGGSGGG              G          F                                                                                                                                                               
   P     GGGGGGG                                                                                                     GG      G             F                                                                                                                                                               
                                                   GSSSSSSSSSSSSSSG                                               SSS     G                F                                                                                                                                                               
GGGGGGGGGGGGGGGGGGGGGGGGGGGGGGGGGGGGGGGGGGGGGGGGGGGGGGGGGGGGGGGGGGGSSSSSSSSSSSSSSGGGGGGGGGGGGGGGGGGGGGGGGGGGGGGGGGGGGGGGGGGGGGGGGGGGGGGGGGGGGGGGGGGGGGGGGGGGGGGGGGGGGGGGGGGGGGGGGGGGGGGGGGGGGGGGGGGGGGGGGGGGGGGGGGGGGGGGGGGGGGGGGGGGGGGGGGGGGGGGGGGGGGGGGGGGGGGGGGGGGGGGGGGGGGGGGGGGGGGGGGGGGGGGGGGGGGGGGGG
