                                                                                                                                           F                                                                                                                                                               
                                                                                                                                           F                                                                                                                                                               
                                                                                                                                           F                                                                                                                                                               
                                                                                                                         @                 F                                                                                                                                                               
                                                                              GGGG  GG  GG  GG  GG  GG  GG  GG  GGGG    GGG                F                                                                                                                                                               
                                                                            G     GS  GS  GS  GS  GS  GS  GS  GS    SSSS       GGGSG       F                                                                                                                                                               
                                                                         G                                                   GG            F                                                                                                                                                               
   P                                                                  G                                                   GGG              F                                                                                                                                                               
          G   G   G   G   G   G   G   G   G   G   G               G                                                                        F                                                                                                                                                               
GGGGGGGGGGGSSSGSSSGSSSGSSSGSSSGSSSGSSSGSSSGSSSGSSSGGGGGGGGGGGGGGGGGSSSSSSSSSSSSSSGGGGGGGGGGGGGGGGGGGGGGGGGGGGGGGGGGGGGGGGGGGGGGGGGGGGGGGGGGGGGGGGGGGGGGGGGGGGGGGGGGGGGGGGGGGGGGGGGGGGGGGGGGGGGGGGGGGGGGGGGGGGGGGGGGGGGGGGGGGGGGGGGGGGGGGGGGGGGGGGGGGGGGGGGGGGGGGGGGGGGGGGGGGGGGGGGGGGGGGGGGGGGGGGGGGGGGGGGG
