                                                                                 @                                                                                                                            F                                                                                            
                                                                               GGGGG                                                                                                                          F                                                                                            
                                                                                     G                                                                                                         @              F                                                                                            
                                                                            G          G                                                                                                      GGG             F                                                                                            
                                                               GG                        G                                                                                               GGG                  F                                                                                            
                                                           G             G                 G                                                                                    GSSGGGGGG                     F                                                                                            
                    G              G                   G                                     G   G                                      GGG                                  G                                F                                                                                            
    P               G              G               G                  G                        S   G                      G    G            GGS    S                     G                                    F                                                                                            
                   GGGGS    SGGG S GSSS      GG    GSSSSSSSS GGG GGG  SSSSSSSSSSSSSSSSSSSSSSSSSS     G     S     SS     SSGGGSSG     G          GG      SSGSS        G                                        F                                                                                            
GGGGGGGGGGGGGGGGGGGGGGGGGGGGGGGGGGGGGGGGGGGGGGGGGGGGGGGGGGGGGGGGGGGGGGGGGGGGGGGGGGGGGGGGGGGGGGGGGGGGGGGGGGGGGGGGGGGGGGGGGGGGGGGGGGGGGGGGGGGGGGGGGGGGGGGGGGGGGGGGGGGGGGGGGGGGGGGGGGGGGGGGGGGGGGGGGGGGGGGGGGGGGGGGGGGGGGGGGGGGGGGGGGGGGGGGGGGGGGGGGGGGGGGGGGGGGGGGGGGGGGGGGGGGGGGGGGGGGGGGGGGGGGGGGGGGGGGGGG 
